ah	ah
eh	eh
ae	ae
ee	ee
oe	oe
ih	ih
oh	oh
oo	oo
ou	ou
uh	uh
en	en
in	in
on	on
un	un
ax	ax
ay	ay
ey	ey
ow	ow
aa	aa
ae1	ae1
ah1	ah1
ao	ao
eh1	eh1
er	er
ih1	ih1
iy	iy
oy	oy
uh1	uh1
uw	uw
aw	aw
a	a
i	i
e	e
o	o
u	u
nn	nn
y	y
w	w
uy	uy
tr	tr
tx	tx
dh	dh
dr	dr
dz	dz
f	f
k	k
p	p
rx	rx
s	s
sh	sh
t	t
h	h
ts	ts
ch	ch
th	th
b	b
d	d
g	g
l	l
m	m
n	n
r	r
v	v
z	z
j	j
ng	ng
rh	rh
dx	dx
rr	rr
jh	jh
q	q
vf	vf
cl	cl
axh	axh
ctrash	ctrash
vtrash	vtrash
